R 1080 1080

NO ./textures/1.xpm
SO ./textures/2.xpm
WE ./textures/3.xpm  
EA ./textures/4.xpm
S ./textures/sp.xpm


F 29,239,249
C 98,253,9


        111111111111111111111111111111111111111111111111111
        100000000000000000000000000000000000000000000000001
        100000000000000000200000000000000000000000000000001
        100020000000000000000000111111111111111111110000001
111111111000000000000000000000001                  10000001
100000000000000000000111111111111                  10000001
100000000000000000000000001                        10002001
10000000000N000000002000001111                     11111111
100020000000000000000000001111
100000000000000000000000001111111111111
1000000000000000000000000011
11000001110101011111011000001
11110111 1111111 101111000001
11111111 1111111 111111111111 
